NO xpm/LAB_4A.xpm
SO xpm/wall_64.xpm
WE xpm/exit.xpm
EA xpm/LAB_4A.xpm

C  5,54,54
F  35,67,0



1111111111111111111111111
1000000000110000000000001
1011000001110000000000001
1001000000000000000000001
1111111110110000011100001
100000000011000001110111111111111
11110111111111011100000010001
11110111111111011101010010001
11000000110101011100000100001
10000000000000001100000010001
1000000000000000110101000001
11000001110101011111011100N0111
11110111 1110101 101111010001
11111111 1111111 111111111111






